11111111111111111111111111111111111111111111111111111111111111111111111111111111111111111111111111111111111111111111111111111111111111111111111111111111111111111111111111111111111111111111111111111111111100000
11111111111111111111111111111111111111111111111111111111111111111111111111111111111111111111111111111111111111111111111111111111111111111111111111111111111111111111111111111111111111111111111111111111111100000
11111111111111111111111111000000000000011111111111111111111111111111111111111111111110000000000000111111111111111111111111111111111111111111111000000000000011111111111111111111111111111111111111111111111100000
11111111111111111111111111000000000000011111111111111111111111111111111111111111111110000000000000111111111111111111111111111111111111111111111000000000000011111111111111111111111111111111111111111111111100000
11111111111111111111111111000000000000011111111111111111111111111111111111111111111110000000000000111111111111111111111111111111111111111111111000000000000011111111111111111111111111111111111111111111111100000
11111111100000111111111111111110000000000000111111111111111111111111111111111111111111111100000000000001111111111111111100000000000001111111111111110000000000000111111111111111111111111111111111111111111100000
11111111100000111111111111111110000000000000111111111111111111111111111111111111111111111100000000000001111111111111111100000000000001111111111111110000000000000111111111111111111111111111111111111111111111111
11111111100000111111111111111110000000000000111111111111111111111111111111111111111111111100000000000001111111111111111100000000000001111111111111110000000000000111111111111111111111111111111111111111111111111
11111111111111111111111111000000000000011111111111111111111111111111111111111111111110000000000000111111111111111110000000000000111111111111111000000000000011111111111111111111111111111111111111111111111100000
11111111111111111111111111111111111111111111111111111111111111111100000000000011111111111111111111111111111111111110000000000000111111111111111111111111111111111111111111111111100000000000001111111111111100000
11111111111111111111111111111111111111111111111111111111111111111100000000000011111111111111111111111111111111111110000000000000111111111111111111111111111111111111111111111111100000000000001111111111111100000
11111111111111111111111111111111111111111111111111111111111111111100000000000011111111111111111111111111111111111110000000000000111111111111111111111111111111111111111111111111100000000000001111111111111100000
11111110000011111111111111111111111111111111111111111111111111111111111000000000000111111111111111111111111111111111111111111111111111111111111111111111111111111111111111111111111111000000000000011111111100000
11111110000011111111111111111111111111111111111111111111111111111111111000000000000111111111111111111111111111111111111111111111111111111111111111111111100000000000001111111111111111000000000000011111111100000
11111110000011111111111111111111110000000000000111111111111111111111111000000000000111111111111111111111111111111111111111111111111111111111111111111111100000000000001111111111111111000000000000011111111111111
11111111111111111111111111111000000000000011111111111111111111111100000000000011111111111111111111100000111111111111111111111111111111111111111111111111100000000000001111111111111111000000000000011111111111111
11111111111111111111111111111000000000000011111111111111111111111111111111111111111111111111111111100000111111111111111111111111111111111111111111111111100000000000001111111111111111111111111111111111111111111
11111111111111111111111111111000000000000011111111111111111111111111111111111111111111111111111111100000111111111111111111111111111111111111111111111111100000000000001111111111111111111111111111111111111111111
11111111111111111111111111111000000000000011111111111111111111111111111111111111111111111111111111111111111111111111111110000000000000111111111111110000000000000111111111111111111111111111111111111111111100000
11111111111111111111111111111000000000000011111111111111111000001111111111111111111111111111111111111111111111111111111111111100000000000001111111111111100000000000001111111111111111111111111111111111111100000
11111111111111111111111111111000000000000011111111111111111000001111111111111111111111111111111111111111111111111111111111111100000000000001111111111111111111111111111111111111111110000001111111111111111100000
11111111111111111111111111111111110000000000000111111111111000001111111111111111111111111111111100000000000001111111111111111100000000000001111111111111111111111111111111111111111110000001111111111111111111111
11111111111111111111111111111111110000000000000111111111111111111111111111111111111111111110000000000000111111111111111110000000000000111111111111111111111111111100000111111111111110000001111111111111111111111
11111111111111111111111111111111110000000000000111111111111111111111111111111111111111111110000000000000111111111111111110000000000000111111111111111111111111111100000111111111111110000001111111111111111111111
11111111111111111111111111111111110000000000000111111111111111111111111111111111111111111110000000000000111111111111111110000000000000111111111111111111111111111100000111111111111111111111111111111111111111111
11110000000000000111111111111111111111111111111000000000000011111111111111111111111111111111111111111111000000000000011111111111111111111111111111111111111111111111111111111111111111111111111111111111111100000
11110000000000000111111111111111111111111111111000000000000011111111111111111111111111111111111111111111000000000000011111111111111111111111111111111111111111111111111111111111111111111111111111111111111100000
11110000000000000111111111111111111111111111111000000000000011111111111111111111111111111111111111111111000000000000011111111111111111111111111111111111111111111111111111111111111111111111111111111111111100000
11110000000000000111111111111111111111111111111111111111111111111111111111111111111111111111111111111111111111111111111111111111111111111111111111111111111111111111111111111111111111111111111111111111111100000
11110000000000000111111111111111111111111111111111111111111111111111111111111111111111111111111111111111111111111111111111111111111111111111111111111111111100000000000001111111111111111111111111111111111100000
11110000000000000111111111111111111111111111111111111111111111111111111111100000111111111111111111111111111111111111111111111111111111111111111111111111111111111000000000000011111111111111111111111111111100000
11110000000000000111111111111111111111111111111111111111111111111111111111100000111111111111111111111111110000011111111111111111111111111111111111111111111111111111110000000000000111111111111111111111111111111
11111111111111111111111111111111111111111111111111111111111111111111111111100000111111111111111111111111110000011111111111111111111111111111111111111111100000000000001111111111111111111111111111111111111111111
11111111111111111111111111111111111111111111111111110000011111111111111111111111111111111111111111111111110000011111111111111111111111111111111111111111100000000000001111111111111111111111111111111111111111111
11111111111111111111111111111111111111111111111111110000011111111111111111111111111111111111111111111111111111111111111111111111111111111111111111110000000000000111111111111111111111111111111111111111111111111
11111111111111111111111111111111111111111111111111110000011111111111111111111111111111111111111111111111111111111111111111111111111111111111111111110000000000000111111111111111111111111111000001111111111111111
